5
-T-------
---T---T--
T-P--T---
--T--TT--
----T-TT-
-T--T1---
-----T-T-
T----T---
--T---T--