7
-----T---
--T----T-
---------
T--TTT---
-T-T5T-T-
---TTT-T-
T-------T
----P-T--
-T--T-T--