0
--T------
------T--
---1-----
-T--T---T
--TP-----
-------3-
--T--T---
----T----
------T--