3
-T--T--T-
--T------
-----T5--
----T----
--T-P----
T----T---
--5T-----
---5-T---
T-----T--