5
-TTTTTTT-
-1-------
---T-----
---------
---------
----W----
--P------
---------
---------