1
---T-----
----T--T-
--T------
-T---1---
-----T-T-
-5T-P----
-------T-
T--T-----
-T---T---