4
T-----T--
--T-P---T
T--TTT-T-
-----T--T
-TT---T--
--T3----T
T---TT-T-
T-T----T-
----T----