0
--T------
----T----
-T-------
---------
----1----
--T------
-----T---
P------T-
--T------