2
--P------
-----T---
-T-----T-
---------
T--------
------T-T
-T----T--
------T--
---T--5-T