0
--T------
------T--
---1-----
-T--T---T
--TP-----
-------4-
--T--T---
----T----
------T--