7
-----T---
--T----T-
---------
T--TTT---
-T-T4T-T-
---TTT-T-
T-------T
----P-T--
-T--T-T--